                                                   
 yyyyyyyyyyyyyyyyyyyyyyyyyyyyyyyyyyyyyyyyyyyyyyyyyy
 x P                                              x
 x                                                x
 x                                                x
 x                 zzzz                           x
 x                 z  z                           x
 x                 z  z                           x
 x                 zzzz                           x
 x                                                x
 x                          zzzz                  x
 x                          z  x                  x
 x                          z  z                  x
 x                          zzzz                  x
 x                                                x
 x                                                x
 x                                                x
 x                                                x
 yyyyyyyyyyyyyyyyyyyyyyyyyyyyyyyyyyyyyyyyyyyyyyyyyy